2 5 481 94 281 698 551 
2 5 551 652 710 354 782 
1 7 782 600 721 293 775 771 73 
1 5 771 770 259 769 125 
1 5 533 761 57 172 73 
1 4 704 491 624 533 
3 5 481 797 735 230 557 
2 5 812 809 400 252 557 
2 6 812 490 712 326 261 802 
1 5 326 48 714 484 363 
1 7 363 644 474 202 112 840 841 
1 8 712 593 824 500 463 329 36 524 
1 6 100 27 26 359 467 279 
1 8 100 868 683 102 873 92 254 885 
1 6 103 623 194 389 302 916 
1 6 103 334 896 893 890 885 
3 10 812 815 398 830 527 246 12 702 210 428 
2 6 428 564 220 870 59 350 
2 6 350 681 406 313 723 213 
2 4 916 910 81 213 
2 6 675 894 891 886 223 591 
2 6 675 322 586 461 905 213 
1 5 591 515 361 865 415 
2 6 515 672 871 255 708 564 
2 8 377 932 588 436 582 919 51 916 
2 7 972 967 959 392 664 626 377 
1 6 946 148 929 924 920 302 
1 6 946 952 954 635 960 592 
1 4 592 648 385 663 
1 4 663 965 530 972 
1 4 840 545 221 45 
2 6 441 996 999 358 69 1014 
1 10 244 353 78 263 1021 316 64 1031 232 625 
2 20 997 1001 349 744 91 140 1016 717 1019 323 407 642 1022 602 11 1027 1029 543 144 420 
2 4 420 1035 1038 1041 
2 8 1035 270 1036 625 1040 1043 1046 645 
2 8 645 157 1064 1067 693 503 1071 274 
2 13 274 1076 280 34 706 283 520 154 396 1092 1094 502 620 
1 15 620 139 609 1103 1106 310 357 403 1110 473 538 421 575 233 1116 
1 6 575 448 1111 331 250 43 
1 7 15 166 1093 186 46 1101 331 
1 6 1110 1105 217 344 442 186 
1 11 609 746 14 356 286 651 135 1085 133 312 71 
1 4 1071 72 285 314 
1 6 520 469 1079 66 562 227 
2 4 1041 452 298 1040 
2 8 1046 523 158 373 1050 241 115 1041 
